00000000000000
11110000011111
11111111111111
11110000011111
00000000000000
